number,code,entryTime,Out_time,Work_time,block,In_yard_truck
1,in_out,4,40,36,C,0
2,in_out,8,35,27,B,1
3,in,11,39,28,A,2
4,out,18,26,8,A,3
5,in,22,49,27,A,4
6,in_out,28,60,32,C,4
7,in_out,36,68,32,B,4
8,in,41,57,16,A,3
9,out,44,56,12,C,4
10,in_out,47,88,41,A,5
11,in,51,78,27,B,5
12,out,54,65,11,B,6
13,in,60,88,28,C,5
14,in,67,89,22,B,4
15,in,73,92,19,C,4
16,out,79,95,16,C,4
17,out,86,105,19,B,5
18,in_out,89,126,37,A,4
19,in,92,105,13,C,4
20,out,98,116,18,C,3
21,out,105,123,18,B,4
22,in_out,113,139,26,B,3
23,in_out,117,154,37,C,3
24,out,124,138,14,C,3
25,in,128,149,21,B,3
26,in_out,131,167,36,A,4
27,in_out,137,169,32,B,5
28,in,145,162,17,C,4
29,out,153,163,10,C,4
30,out,158,167,9,A,4
31,in_out,162,181,19,A,5
32,in,168,183,15,B,2
33,out,174,186,12,C,2
34,in,179,197,18,C,3
35,in,182,208,26,C,3
36,in,188,202,14,B,2
37,in,191,215,24,A,3
38,out,196,206,10,A,4
39,in_out,204,239,35,A,3
40,in_out,209,252,43,B,2
41,in_out,212,245,33,C,3
42,in_out,219,259,40,C,3
43,in,223,246,23,A,4
44,in,231,259,28,C,5
45,in_out,238,277,39,C,6
46,in,242,254,12,A,6
47,in,246,274,28,C,6
48,in_out,249,288,39,B,6
49,in_out,256,289,33,A,5
50,in,263,288,25,B,4
51,in,267,280,13,B,5
52,in_out,273,308,35,A,6
53,in,277,292,15,A,6
54,out,281,299,18,A,5
55,in_out,284,318,34,A,6
56,out,290,306,16,A,4
57,in,294,319,25,B,4
58,in,302,316,14,C,4
59,in,307,334,27,C,4
60,in,315,334,19,B,4
61,in_out,318,354,36,B,4
62,in_out,323,346,23,A,3
63,out,326,335,9,C,4
64,out,331,347,16,C,5
65,out,337,353,16,B,3
66,in,343,363,20,A,4
67,in,350,373,23,A,3
68,in_out,353,381,28,B,4
69,in_out,357,382,25,A,3
70,out,364,378,14,A,3
71,in_out,371,404,33,A,4
72,in,374,390,16,C,4
73,out,377,389,12,C,5
74,out,383,393,10,A,3
75,in,386,409,23,A,4
76,in_out,390,416,26,B,4
77,out,397,406,9,B,3
78,in,404,419,15,A,4
79,in_out,410,448,38,A,2
80,in_out,418,448,30,B,2
81,in,421,447,26,A,2
82,in_out,424,455,31,A,3
83,in,428,451,23,A,4
84,in,433,456,23,C,5
85,out,438,449,11,B,6
86,in,445,464,19,B,7
87,in,451,476,25,B,4
88,in,457,477,20,B,2
89,out,461,477,16,C,3
90,in_out,468,509,41,B,3
91,out,473,492,19,A,4
92,out,476,493,17,A,5
93,in,480,506,26,C,3
94,in,484,507,23,C,4
95,out,492,508,16,A,5
96,in,497,523,26,B,4
97,in,503,530,27,B,5
98,in,506,525,19,A,6
99,in,512,540,28,B,3
100,in,519,540,21,A,4
101,out,526,543,17,C,3
102,out,530,537,7,C,4
103,in_out,533,560,27,B,4
104,in,541,558,17,A,2
105,out,547,557,10,C,2
106,out,550,565,15,C,3
107,in_out,556,591,35,B,4
108,in,564,579,15,C,2
109,in_out,571,611,40,A,2
110,in,577,604,27,B,3
111,out,584,594,10,A,3
112,in_out,592,625,33,B,3
113,out,598,614,16,A,3
114,out,602,613,11,A,4
115,in,609,626,17,C,4
116,in_out,613,636,23,A,4
117,in_out,620,650,30,B,3
118,in,623,650,27,A,4
119,in_out,631,662,31,B,3
120,out,636,648,12,A,4
121,in,641,665,24,A,4
122,in,644,663,19,C,5
123,out,647,663,16,C,6
124,in_out,654,690,36,A,4
125,in,661,686,25,C,5
126,in,665,686,21,A,3
127,in_out,668,705,37,A,3
128,in,674,698,24,C,4
129,in_out,677,715,38,C,5
130,in_out,680,704,24,A,6
131,out,687,701,14,A,5
132,in,691,712,21,A,5
133,out,697,709,12,B,6
134,in_out,701,728,27,B,6
135,out,706,717,11,A,4
136,out,713,728,15,B,3
137,out,719,733,14,C,2
138,in,724,748,24,C,3
139,in_out,727,754,27,C,4
140,in_out,731,756,25,C,3
141,in,738,768,30,C,3
142,in_out,744,767,23,C,4
143,out,750,768,18,A,4
144,out,753,766,13,C,5
145,out,756,767,11,B,5
146,in,761,777,16,B,5
147,in_out,764,798,34,C,6
148,in,771,794,23,B,2
149,out,775,794,19,C,3
150,out,778,791,13,B,3
151,in,782,810,28,B,4
152,in,790,813,23,C,5
153,in_out,798,838,40,B,3
154,in_out,801,827,26,B,3
155,in,809,825,16,C,4
156,in_out,813,840,27,A,4
157,in,818,846,28,B,4
158,in_out,824,851,27,B,5
159,in,831,856,25,A,4
160,in,834,851,17,C,5
161,in_out,841,883,42,C,4
162,out,849,863,14,B,4
163,in_out,854,881,27,B,3
164,out,862,877,15,A,3
165,out,867,887,20,B,3
166,out,874,886,12,C,4
167,in_out,879,907,28,C,4
168,out,883,898,15,A,4
169,in,889,917,28,B,2
170,out,897,907,10,C,3
171,in,901,929,28,A,3
172,in,904,931,27,A,4
173,in_out,908,932,24,C,3
174,in_out,916,939,23,C,4
175,in,919,937,18,A,4
176,in,922,937,15,B,5
177,out,929,941,12,C,6
178,in,937,965,28,B,4
179,in,942,965,23,B,1
180,in,946,970,24,C,2
181,in,954,968,14,A,3
182,out,957,964,7,B,4
183,out,960,971,11,B,5
184,in,963,983,20,A,6
185,in,968,994,26,C,4
186,in_out,972,999,27,B,2
187,in_out,976,1000,24,C,3
188,out,984,1001,17,B,3
189,in,991,1017,26,C,4
190,out,994,1008,14,C,5
191,in,998,1018,20,C,5
192,in_out,1005,1029,24,C,3
193,in_out,1012,1039,27,C,3
194,in,1015,1035,20,A,4
195,in,1022,1043,21,C,3
196,in_out,1029,1052,23,C,4
197,in,1036,1054,18,C,3
198,in,1040,1063,23,B,3
199,in_out,1048,1075,27,B,3
200,out,1056,1067,11,A,2
201,in,1064,1094,30,B,2
202,in,1070,1090,20,B,2
203,in_out,1076,1103,27,C,2
204,in_out,1082,1113,31,B,3
205,out,1086,1101,15,C,4
206,out,1091,1106,15,C,4
207,out,1099,1108,9,C,4
208,in,1106,1127,21,C,3
209,in,1111,1127,16,B,2
210,in,1114,1127,13,C,2
211,in_out,1120,1141,21,A,3
212,out,1126,1144,18,A,4
213,in_out,1132,1162,30,A,2
214,in,1137,1159,22,A,3
215,out,1145,1157,12,A,2
216,out,1150,1162,12,C,3
217,in_out,1156,1195,39,C,4
218,out,1163,1173,10,A,1
219,in,1168,1190,22,B,2
220,in_out,1174,1207,33,A,2
221,in_out,1178,1203,25,A,3
222,in,1184,1211,27,C,4
223,in_out,1189,1230,41,B,5
224,in_out,1193,1221,28,C,5
225,out,1201,1216,15,B,5
226,out,1204,1223,19,B,5
227,in,1212,1236,24,A,4
228,in_out,1219,1256,37,A,4
229,in,1226,1254,28,A,3
230,in,1230,1244,14,C,4
231,in,1236,1258,22,C,4
232,in,1239,1258,19,C,4
233,in,1245,1260,15,B,4
234,out,1252,1268,16,C,5
235,out,1258,1267,9,C,4
236,in,1261,1275,14,A,2
237,out,1267,1282,15,B,3
238,in_out,1274,1309,35,B,2
239,out,1278,1288,10,C,2
240,out,1286,1303,17,A,2
241,out,1292,1305,13,A,2
242,in_out,1298,1330,32,B,3
243,in,1305,1327,22,C,3
244,in,1311,1328,17,B,2
245,out,1319,1336,17,B,3
246,in,1325,1339,14,A,4
247,in_out,1333,1370,37,A,2
248,out,1340,1352,12,B,1
249,in,1344,1365,21,B,2
250,in,1350,1379,29,C,3
251,in,1356,1372,16,B,3
252,in,1363,1388,25,A,4
253,out,1371,1385,14,C,3
254,out,1377,1390,13,C,3
255,in,1381,1406,25,B,3
256,out,1387,1404,17,A,3
257,in_out,1394,1424,30,C,2
258,in,1401,1422,21,C,3
259,in,1409,1432,23,B,2
260,in,1417,1435,18,B,3
261,out,1425,1433,8,A,2
